#######################################
# Syntax Coloring Map For the current project.
# This file was generated by doxygen2keywords.xsl.
#######################################

#######################################
# Classes and structs (KEYWORD1)
#######################################

ModbusServerTCP::ClientData	KEYWORD1
CoilData	KEYWORD1
Modbus::FCT	KEYWORD1
ModbusBridge	KEYWORD1
ModbusClient	KEYWORD1
ModbusClientTCP	KEYWORD1
ModbusClientRTU	KEYWORD1
ModbusClientTCPasync	KEYWORD1
ModbusError	KEYWORD1
ModbusMessage	KEYWORD1
ModbusServer	KEYWORD1
ModbusServerTCP	KEYWORD1
ModbusServerRTU	KEYWORD1
ModbusServerTCPasync	KEYWORD1
RTUutils	KEYWORD1

#######################################
# Methods (KEYWORD2)
#######################################

ClientData	KEYWORD2
~ClientData	KEYWORD2
CoilData	KEYWORD2
~CoilData	KEYWORD2
coils	KEYWORD2
coilsSetON	KEYWORD2
coilsSetOFF	KEYWORD2
FCT	KEYWORD2
getType	KEYWORD2
redefineType	KEYWORD2
ModbusBridge	KEYWORD2
attachServer	KEYWORD2
addFunctionCode	KEYWORD2
denyFunctionCode	KEYWORD2
bridgeWorker	KEYWORD2
bridgeDenyWorker	KEYWORD2
onDataHandler	KEYWORD2
onErrorHandler	KEYWORD2
onResponseHandler	KEYWORD2
getMessageCount	KEYWORD2
getErrorCount	KEYWORD2
resetCounts	KEYWORD2
addRequest	KEYWORD2
syncRequest	KEYWORD2
buildErrorMsg	KEYWORD2
addRequest	KEYWORD2
ModbusClient	KEYWORD2
waitSync	KEYWORD2
ModbusClientTCPasync	KEYWORD2
setTimeout	KEYWORD2
setIdleTimeout	KEYWORD2
setMaxInflightRequests	KEYWORD2
addToQueue	KEYWORD2
ModbusError	KEYWORD2
getText	KEYWORD2
ModbusMessage	KEYWORD2
data	KEYWORD2
size	KEYWORD2
push_back	KEYWORD2
clear	KEYWORD2
resize	KEYWORD2
begin	KEYWORD2
end	KEYWORD2
append	KEYWORD2
getServerID	KEYWORD2
getFunctionCode	KEYWORD2
getError	KEYWORD2
setFunctionCode	KEYWORD2
add	KEYWORD2
get	KEYWORD2
setMessage	KEYWORD2
setError	KEYWORD2
determineFloatOrder	KEYWORD2
determineDoubleOrder	KEYWORD2
swapFloat	KEYWORD2
swapDouble	KEYWORD2
getOne	KEYWORD2
registerWorker	KEYWORD2
getWorker	KEYWORD2
unregisterWorker	KEYWORD2
isServerFor	KEYWORD2
getMessageCount	KEYWORD2
getErrorCount	KEYWORD2
resetCounts	KEYWORD2
localRequest	KEYWORD2
listServer	KEYWORD2
ModbusServer	KEYWORD2
ModbusServerTCP	KEYWORD2
activeClients	KEYWORD2
start	KEYWORD2
stop	KEYWORD2
clientAvailable	KEYWORD2
ModbusServerTCPasync	KEYWORD2
isRunning	KEYWORD2
calcCRC	KEYWORD2
validCRC	KEYWORD2
addCRC	KEYWORD2
calculateInterval	KEYWORD2
prepareHardwareSerial	KEYWORD2
RTUutils	KEYWORD2
ServerData	KEYWORD2
NIL_RESPONSE	KEYWORD2
ECHO_RESPONSE	KEYWORD2

#######################################
# Constants (LITERAL1)
#######################################

DISCONNECTED	LITERAL1
CONNECTING	LITERAL1
CONNECTED	LITERAL1
ANY_FUNCTION_CODE	LITERAL1
READ_COIL	LITERAL1
READ_DISCR_INPUT	LITERAL1
READ_HOLD_REGISTER	LITERAL1
READ_INPUT_REGISTER	LITERAL1
WRITE_COIL	LITERAL1
WRITE_HOLD_REGISTER	LITERAL1
READ_EXCEPTION_SERIAL	LITERAL1
DIAGNOSTICS_SERIAL	LITERAL1
READ_COMM_CNT_SERIAL	LITERAL1
READ_COMM_LOG_SERIAL	LITERAL1
WRITE_MULT_COILS	LITERAL1
WRITE_MULT_REGISTERS	LITERAL1
REPORT_SERVER_ID_SERIAL	LITERAL1
READ_FILE_RECORD	LITERAL1
WRITE_FILE_RECORD	LITERAL1
MASK_WRITE_REGISTER	LITERAL1
R_W_MULT_REGISTERS	LITERAL1
READ_FIFO_QUEUE	LITERAL1
ENCAPSULATED_INTERFACE	LITERAL1
USER_DEFINED_41	LITERAL1
USER_DEFINED_42	LITERAL1
USER_DEFINED_43	LITERAL1
USER_DEFINED_44	LITERAL1
USER_DEFINED_45	LITERAL1
USER_DEFINED_46	LITERAL1
USER_DEFINED_47	LITERAL1
USER_DEFINED_48	LITERAL1
USER_DEFINED_64	LITERAL1
USER_DEFINED_65	LITERAL1
USER_DEFINED_66	LITERAL1
USER_DEFINED_67	LITERAL1
USER_DEFINED_68	LITERAL1
USER_DEFINED_69	LITERAL1
USER_DEFINED_6A	LITERAL1
USER_DEFINED_6B	LITERAL1
USER_DEFINED_6C	LITERAL1
USER_DEFINED_6D	LITERAL1
USER_DEFINED_6E	LITERAL1
SUCCESS	LITERAL1
ILLEGAL_FUNCTION	LITERAL1
ILLEGAL_DATA_ADDRESS	LITERAL1
ILLEGAL_DATA_VALUE	LITERAL1
SERVER_DEVICE_FAILURE	LITERAL1
ACKNOWLEDGE	LITERAL1
SERVER_DEVICE_BUSY	LITERAL1
NEGATIVE_ACKNOWLEDGE	LITERAL1
MEMORY_PARITY_ERROR	LITERAL1
GATEWAY_PATH_UNAVAIL	LITERAL1
GATEWAY_TARGET_NO_RESP	LITERAL1
TIMEOUT	LITERAL1
INVALID_SERVER	LITERAL1
CRC_ERROR	LITERAL1
FC_MISMATCH	LITERAL1
SERVER_ID_MISMATCH	LITERAL1
PACKET_LENGTH_ERROR	LITERAL1
PARAMETER_COUNT_ERROR	LITERAL1
PARAMETER_LIMIT_ERROR	LITERAL1
REQUEST_QUEUE_FULL	LITERAL1
ILLEGAL_IP_OR_PORT	LITERAL1
IP_CONNECTION_FAILED	LITERAL1
TCP_HEAD_MISMATCH	LITERAL1
EMPTY_MESSAGE	LITERAL1
ASCII_FRAME_ERR	LITERAL1
ASCII_CRC_ERR	LITERAL1
ASCII_INVALID_CHAR	LITERAL1
BROADCAST_ERROR	LITERAL1
UNDEFINED_ERROR	LITERAL1
FC01_TYPE	LITERAL1
FC07_TYPE	LITERAL1
FC0F_TYPE	LITERAL1
FC10_TYPE	LITERAL1
FC16_TYPE	LITERAL1
FC18_TYPE	LITERAL1
FCGENERIC	LITERAL1
FCUSER	LITERAL1
FCILLEGAL	LITERAL1
PrintOut	LITERAL1
LOG_LEVEL	LITERAL1
LOCAL_LOG_LEVEL	LITERAL1
LOG_LEVEL_NONE	LITERAL1
LOG_LEVEL_CRITICAL	LITERAL1
LOG_LEVEL_ERROR	LITERAL1
LOG_LEVEL_WARNING	LITERAL1
LOG_LEVEL_INFO	LITERAL1
LOG_LEVEL_DEBUG	LITERAL1
LOG_LEVEL_VERBOSE	LITERAL1
LL_RED	LITERAL1
LL_GREEN	LITERAL1
LL_YELLOW	LITERAL1
LL_BLUE	LITERAL1
LL_MAGENTA	LITERAL1
LL_CYAN	LITERAL1
LL_NORM	LITERAL1
LOG_HEADER	LITERAL1
LOG_LINE_C	LITERAL1
LOG_LINE_E	LITERAL1
LOG_LINE_T	LITERAL1
LOG_RAW_C	LITERAL1
LOG_RAW_E	LITERAL1
LOG_RAW_T	LITERAL1
HEX_DUMP_T	LITERAL1
LOG_N	LITERAL1
LOGRAW_N	LITERAL1
HEXDUMP_N	LITERAL1
LOG_C	LITERAL1
LOGRAW_C	LITERAL1
HEXDUMP_C	LITERAL1
LOG_E	LITERAL1
LOGRAW_E	LITERAL1
HEXDUMP_E	LITERAL1
LOG_W	LITERAL1
LOGRAW_W	LITERAL1
HEXDUMP_W	LITERAL1
LOG_I	LITERAL1
LOGRAW_I	LITERAL1
HEXDUMP_I	LITERAL1
LOG_D	LITERAL1
LOGRAW_D	LITERAL1
HEXDUMP_D	LITERAL1
LOG_V	LITERAL1
LOGRAW_V	LITERAL1
HEXDUMP_V	LITERAL1
LOCAL_LOG_LEVEL	LITERAL1
TCP_SERVER	LITERAL1
RTU_SERVER	LITERAL1
SERVER_END	LITERAL1
LOCAL_LOG_LEVEL	LITERAL1
DEFAULTTIMEOUT	LITERAL1
DEFAULTIDLETIME	LITERAL1
LOCAL_LOG_LEVEL	LITERAL1
SERVER_END	LITERAL1
SWAP_BYTES	LITERAL1
SWAP_REGISTERS	LITERAL1
SWAP_WORDS	LITERAL1
SWAP_NIBBLES	LITERAL1
LOCK_GUARD	LITERAL1
